ab: The fifth month of the Jewish year according to theecclesiastical reckoning, the eleventh by the civil computation,coinciding nearly with August. W. Smith.

aback: Backward against the mast;-said of the sails when pressed bythe wind. Totten. To be taken aback. (a) To be driven backwardagainst the mast; -- said of the sails, also of the ship when thesails are thus driven. (b) To be suddenly checked, baffled, ordiscomfited. Dickens.

abaft: Behind; toward the stern from; as, abaft the wheelhouse. Abaftthe beam. See under Beam.

abalone: A univalve mollusk of the genus Haliotis. The shell is linedwith mother-of-pearl, and used for ornamental purposes; the sea-ear.Several large species are found on the coast of California, clingingclosely to the rocks.

abandon: To relinquish all claim to; -- used when an insured persongives up to underwriters all claim to the property covered by apolicy, which may remain after loss or damage by a peril insuredagainst.

abandonedly: Unrestrainedly.

abandonment: The relinquishment by the insured to the underwriters of whatmay remain of the property insured after a loss or damage by a perilinsured against.

abasement: The act of abasing, humbling, or bringing low; the state ofbeing abased or humbled; humiliation.

abash: To destroy the self-possession of; to confuse or confound, asby exciting suddenly a consciousness of guilt, mistake, orinferiority; to put to shame; to disconcert; to discomfit.Abashed, the devil stood, And felt how awful goodness is. Milton.He was a man whom no check could abash. Macaulay.

abashedly: In an abashed manner.

abashment: The state of being abashed; confusion from shame.

abate: (a) To bring entirely down or put an end to; to do away with;as, to abate a nuisance, to abate a writ. (b) (Eng. Law) To diminish;to reduce. Legacies are liable to be abated entirely or inproportion, upon a deficiency of assets. To abate a tax, to remit iteither wholly or in part.

abatement: A mark of dishonor on an escutcheon.

abattoir: A public slaughterhouse for cattle, sheep, etc.

abbacy: The dignity, estate, or jurisdiction of an abbot.

abbe: The French word answering to the English abbot, the head of anabbey; but commonly a title of respect given in France to every onevested with the ecclesiastical habit or dress.

abbess: A female superior or governess of a nunnery, or convent ofnuns, having the same authority over the nuns which the abbots haveover the monks. See Abbey.

abbreviate: To reduce to lower terms, as a fraction.

abbreviated: Shortened; relatively short; abbreviate.

abbreviation: One dash, or more, through the stem of a note, dividing itrespectively into quavers, semiquavers, or demi-semiquavers. Moore.

abdicate: To disclaim and expel from the family, as a father his child;to disown; to disinherit.

abdication: The act of abdicating; the renunciation of a high office,dignity, or trust, by its holder; commonly the voluntary renunciationof sovereign power; as, abdication of the throne, government, power,authority.

abdicator: One who abdicates.

abdomen: The belly, or that part of the body between the thorax and thepelvis. Also, the cavity of the belly, which is lined by theperitoneum, and contains the stomach, bowels, and other viscera. Inman, often restricted to the part between the diaphragm and thecommencement of the pelvis, the remainder being called the pelviccavity.

abdominal: Having abdominal fins; belonging to the Abdominales; as,abdominal fishes. Abdominal ring (Anat.), a fancied ringlike openingon each side of the abdomen, external and superior to the pubes; --called also inguinal ring.

abduction: The movement which separates a limb or other part from theaxis, or middle line, of the body.

abductor: A muscle which serves to draw a part out, or form the medianline of the body; as, the abductor oculi, which draws the eyeoutward.

abeam: On the beam, that is, on a line which forms a right angle withthe ship's keel; opposite to the center of the ship's side.

abecedarian: Pertaining to, or formed by, the letters of the alphabet;alphabetic; hence, rudimentary. Abecedarian psalms, hymns, etc.,compositions in which (like the 119th psalm in Hebrew) distinctportions or verses commence with successive letters of the alphabet.Hook.

aberrant: See Aberr.]

aberration: A small periodical change of position in the stars and otherheavenly bodies, due to the combined effect of the motion of lightand the motion of the observer; called annual aberration, when theobserver's motion is that of the earth in its orbit, and dairy ordiurnal aberration, when of the earth on its axis; amounting whengreatest, in the former case, to 20.4'', and in the latter, to 0.3''.Planetary aberration is that due to the motion of light and themotion of the planet relative to the earth.

aberrational: Characterized by aberration.

abet: To contribute, as an assistant or instigator, to the commissionof an offense.

abetment: The act of abetting; as, an abetment of treason, crime, etc.

abeyance: Expectancy; condition of being undetermined.

abeyant: Being in a state of abeyance.

abhor: To protest against; to reject solemnly. [Obs.]I utterly abhor, yea, from my soul Refuse you for my judge. Shak.

abhorrence: Extreme hatred or detestation; the feeling of utter dislike.

abhorrently: With abhorrence.

abhorrer: One who abhors. Hume.

abib: The first month of the Jewish ecclesiastical year,corresponding nearly to our April. After the Babylonish captivitythis month was called Nisan. Kitto.

abidance: The state of abiding; abode; continuance; compliance (with).The Christians had no longer abidance in the holy hill of Palestine.Fuller.A judicious abidance by rules. Helps.

abide: To stand the consequences of; to answer for; to suffer for.Dearly I abide that boast so vain. Milton.

abiding: Continuing; lasting.

abidingly: Permanently. Carlyle.

abigail: A lady's waiting-maid. Pepys.Her abigail reported that Mrs. Gutheridge had a set of night curlsfor sleeping in. Leslie.

ability: The quality or state of being able; power to perform, whetherphysical, moral, intellectual, conventional, or legal; capacity;skill or competence in doing; sufficiency of strength, skill,resources, etc.; -- in the plural, faculty, talent.Then the disciples, every man according to his ability, determined tosend relief unto the brethren. Acts xi. 29.Natural abilities are like natural plants, that need pruning bystudy. Bacon.The public men of England, with much of a peculiar kind of ability.Macaulay.

abject: To cast off or down; hence, to abase; to degrade; to lower; todebase. [Obs.] Donne.

abjectly: Meanly; servilely.

abjectness: The state of being abject; abasement; meanness; servility.Grew.

abjuratory: Containing abjuration.

abjure: To renounce on oath. Bp. Burnet.

abjurer: One who abjures.

ablation: Extirpation. Dunglison.

ablative: Applied to one of the cases of the noun in Latin and some otherlanguages, -- the fundamental meaning of the case being removal,separation, or taking away.

ablaut: The substitution of one root vowel for another, thus indicatinga corresponding modification of use or meaning; vowel permutation;as, get, gat, got; sing, song; hang, hung. Earle.

able: Legally qualified; possessed of legal competence; as, able toinherit or devise property.

abloom: In or into bloom; in a blooming state. Masson.

ablution: A small quantity of wine and water, which is used to wash thepriest's thumb and index finger after the communion, and which then,as perhaps containing portions of the consecrated elements, is drunkby the priest.

ably: In an able manner; with great ability; as, ably done, planned,said.

abnegate: To deny and reject; to abjure. Sir E. Sandys. Farrar.

abnegation: a denial; a renunciation.With abnegation of God, of his honor, and of religion, they mayretain the friendship of the court. Knox.

abnegator: One who abnegates, denies, or rejects anything. [R.]

abnormal: Not conformed to rule or system; deviating from the type;anomalous; irregular. "That deviating from the type; anomalous;irregular. " Froude.

abnormally: In an abnormal manner; irregularly. Darwin.

aboard: On board; into or within a ship or boat; hence, into or withina railway car.

abode: of Abide.

abolisher: One who abolishes.

abolishment: The act of abolishing; abolition; destruction. Hooker.

abolition: The act of abolishing, or the state of being abolished; anannulling; abrogation; utter destruction; as, the abolition ofslavery or the slave trade; the abolition of laws, decrees,ordinances, customs, taxes, debts, etc.

abolitionism: The principles or measures of abolitionists. Wilberforce.

abolitionist: A person who favors the abolition of any institution,especially negro slavery.

abominably: In an abominable manner; very odiously; detestably.

abominate: To turn from as ill-omened; to hate in the highest degree, asif with religious dread; loathe; as, to abominate all impiety.

aboriginally: Primarily.

abort: To become checked in normal development, so as either to remainrudimentary or shrink away wholly; to become sterile.

abortifacient: Producing miscarriage.-- n.

abortion: Arrest of development of any organ, so that it remains animperfect formation or is absorbed.

abortionist: One who procures abortion or miscarriage.

abortive: Imperfectly formed or developed; rudimentary; sterile; as, anabortive organ, stamen, ovule, etc.

abortively: In an abortive or untimely manner; immaturely; fruitlessly.

about: On the point or verge of; going; in act of.Paul was now aboutto open his mouth. Acts xviii. 14.

aboveboard: Above the board or table. Hence: in open sight; without trick,concealment, or deception. "Fair and aboveboard." Burke.

abracadabra: A mystical word or collocation of letters written as in thefigure. Worn on an amulet it was supposed to ward off fever. Atpresent the word is used chiefly in jest to denote something withoutmeaning; jargon.

abrade: To rub or wear off; to waste or wear away by friction; as, toabrade rocks. Lyell.

abrasion: A superficial excoriation, with loss of substance under theform of small shreds. Dunglison.

abrasive: Producing abrasion. Ure.

abreast: Side by side; also, opposite; over against; on a line with thevessel's beam; -- with of.

abridger: One who abridges.

abrogate: Abrogated; abolished. [Obs.] Latimer.

abrogation: The act of abrogating; repeal by authority. Hume.

abrogator: One who repeals by authority.

abrupt: Suddenly terminating, as if cut off. Gray.

abruption: A sudden breaking off; a violent separation of bodies.Woodward.

abscess: A collection of pus or purulent matter in any tissue or organof the body, the result of a morbid process. Cold abscess, an abscessof slow formation, unattended with the pain and heat characteristicof ordinary abscesses, and lasting for years without exhibiting anytendency towards healing; a chronic abscess.

abscind: To cut off. [R.] "Two syllables . . . abscinded from the rest."Johnson.

abscissa: One of the elements of reference by which a point, as of acurve, is referred to a system of fixed rectilineal coördinate axes.

abscission: A figure of speech employed when a speaker having begun to saya thing stops abruptly: thus, "He is a man of so much honor andcandor, and of such generosity -- but I need say no more."

abscond: To hide; to conceal. [Obs.] Bentley.

absconder: One who absconds.

absentee: One who absents himself from his country, office, post, orduty; especially, a landholder who lives in another country ordistrict than that where his estate is situated; as, an Irishabsentee. Macaulay.

absenteeism: The state or practice of an absentee; esp. the practice ofabsenting one's self from the country or district where one's estateis situated.

absently: In an absent or abstracted manner.

absolute: Pure; unmixed; as, absolute alcohol.

absolutely: In an absolute, independent, or unconditional manner; wholly;positively.

absoluteness: The quality of being absolute; independence of everythingextraneous; unlimitedness; absolute power; independent reality;positiveness.

absolution: An acquittal, or sentence of a judge declaring and accusedperson innocent. [Obs.]

absolutism: Doctrine of absolute decrees. Ash.

absolutist: One who believes that it is possible to realize a cognition orconcept of the absolute. Sir. W. Hamilton.

absolutistic: Pertaining to absolutism; absolutist.

absolvable: That may be absolved.

absolver: One who absolves. Macaulay.

absorbable: Capable of being absorbed or swallowed up. Kerr.

absorbency: Absorptiveness.

absorbent: Absorbing; swallowing; absorptive. Absorbent ground (Paint.), aground prepared for a picture, chiefly with distemper, or watercolors, by which the oil is absorbed, and a brilliancy is imparted tothe colors.

absorber: One who, or that which, absorbs.

absorbing: Swallowing, engrossing; as, an absorbing pursuit.-- Ab*sorb"ing, adv.

absorption: An imbibing or reception by molecular or chemical action; as,the absorption of light, heat, electricity, etc.

absorptive: Having power, capacity, or tendency to absorb or imbibe. E.Darwin.

absorptivity: Absorptiveness.

absquatulate: To take one's self off; to decamp. [A jocular word. U. S.]

abstain: To hold one's self aloof; to forbear or refrain voluntarily,and especially from an indulgence of the passions or appetites; --with from.Not a few abstained from voting. Macaulay.Who abstains from meat that is not gaunt Shak.

abstainer: One who abstains; esp., one who abstains from the use ofintoxicating liquors.

abstemiousness: The quality of being abstemious, temperate, or sparing in theuse of food and strong drinks. It expresses a greater degree ofabstinence than temperance.

abstention: The act of abstaining; a holding aloof. Jer. Taylor.

abstinent: Refraining from indulgence, especially from the indulgence ofappetite; abstemious; continent; temperate. Beau. & Fl.

abstinently: With abstinence.

abstract: To separate, as the more volatile or soluble parts of asubstance, by distillation or other chemical processes. In this senseextract is now more generally used.

abstractedly: In an abstracted manner; separately; with absence of mind.

abstractedness: The state of being abstracted; abstract character.

abstracter: One who abstracts, or makes an abstract.

abstraction: The act process of leaving out of consideration one or moreproperties of a complex object so as to attend to others; analysis.Thus, when the mind considers the form of a tree by itself, or thecolor of the leaves as separate from their size or figure, the act iscalled abstraction. So, also, when it considers whiteness, softness,virtue, existence, as separate from any particular objects.

abstractly: In an abstract state or manner; separately; absolutely; byitself; as, matter abstractly considered.

abstractness: The quality of being abstract. "The abstractness of the ideas."Locke.

abstrusely: In an abstruse manner.

abstruseness: The quality of being abstruse; difficulty of apprehension.Boyle.

absurd: Contrary to reason or propriety; obviously and fiatly opposedto manifest truth; inconsistent with the plain dictates of commonsense; logically contradictory; nonsensical; ridiculous; as, anabsurd person, an absurd opinion; an absurd dream.This proffer is absurd and reasonless. Shak.'This phrase absurd to call a villain great. Pope.p. 9

absurdly: In an absurd manner.

absurdness: Absurdity. [R.]

abundance: An overflowing fullness; ample sufficiency; great plenty;profusion; copious supply; superfluity; wealth: -- strictlyapplicable to quantity only, but sometimes used of number.It is lamentable to remember what abundance of noble blood hath beenshed with small benefit to the Christian state. Raleigh.

abundant: Fully sufficient; plentiful; in copious supply; -- followed byin, rarely by with. "Abundant in goodness and truth." Exod. xxxiv. 6.Abundant number (Math.), a number, the sum of whose aliquot partsexceeds the number itself. Thus, 1, 2, 3, 4, 6, the aliquot parts of12, make the number 16. This is opposed to a deficient number, as 14,whose aliquot parts are 1, 2, 7, the sum of which is 10; and to aperfect number, which is equal to the sum of its aliquot parts, as 6,whose aliquot parts are 1, 2., 3.

abundantly: In a sufficient degree; fully; amply; plentifully; in largemeasure.

abuser: One who abuses [in the various senses of the verb].

abusively: In an abusive manner; rudely; with abusive language.

abusiveness: The quality of being abusive; rudeness of language, or violenceto the person.Pick out mirth, like stones out of thy ground, Profaneness,filthiness, abusiveness. Herbert.

abut: To project; to terminate or border; to be contiguous; to meet;-- with on, upon, or against; as, his land abuts on the road.

abutter: One who, or that which, abuts. Specifically, the owner of acontiguous estate; as, the abutters on a street or a river.

abuzz: In a buzz; buzzing. [Colloq.] Dickens.

abysm: An abyss; a gulf. "The abysm of hell." Shak.

abysmal: Pertaining to, or resembling, an abyss; bottomless; unending;profound.Geology gives one the same abysmal extent of time that astronomy doesof space. Carlyle.

abysmally: To a fathomless depth; profoundly. "Abysmally ignorant." G.Eliot.

abyss: The center of an escutcheon.

abyssal: Belonging to, or resembling, an abyss; unfathomable. Abyssalzone (Phys. Geog.), one of the belts or zones into which Sir E.Forbes divides the bottom of the sea in describing its plants,animals, etc. It is the one furthest from the shore, embracing allbeyond one hundred fathoms deep. Hence, abyssal animals, plants, etc.

abyssinian: Of or pertaining to Abyssinia. Abyssinian gold, an alloy of90.74 parts of copper and 8.33 parts of zink. Ure.

